{
    "Name":"The Easy Starter Level",
    "MAP": [
        "########################################",
        "#           # #                 #       ",
        "# ##### ### # # ############### ### # # ",
        "#   #   # #   # #     #   #   #   # # # ",
        "##### ### ### # ### # ### # # ### ### ##",
        "#   # #   #   # #   #     # #   #   #   ",
        "# # # ### # ### # ####### # ### ### # # ",
        "# #   #   #   #   #     # #   #   # # # ",
        "# ##### ##### ##### ### # ### ### # ### ",
        "# #   #       #     #   #   # #S#   #   ",
        "# # # # ####### # ####### ### # ##### # ",
        "# # #         # # #       #   # #     # ",
        "# # ######### # # # ####### ### ##### ##",
        "# # #     #     # # #   #   #   #   #   ",
        "# ### ### # ####### # # # ### ### # ### ",
        "#     # # #   #     # # #     #   #     ",
        "# ##### # ##### ##### # ####### ####### ",
        "# #   # #   #   #     # #       #   #   ",
        "# # # # ### # ##### ### ### ##### # # ##",
        "#   # #   # # #     #       #     # # # ",
        "##### ### # # # # ##### ########### # # ",
        "#   #   # #   # #     # #         # # # ",
        "# # ### # ####### ### ### ####### # # # ",
        "# #     #       #   #     # #     #   # ",
        "# ########### # ####### ### # ##### ### ",
        "#     #       #       #     # #   #     ",
        "##### # ############# ### ### # # ##### ",
        "#T    #   #   #   #     # #   # #   #   ",
        "# ####### # # # # ##### ### ### ### # ##",
        "# #   #   # #   #     #     # #   # # # ",
        "# # # # ### ######### ####### ### # # # ",
        "#   # #           # # #   # #     #   # ",
        "##### ########### # # # # # # ####### # ",
        "#     #     # #     #   # #   #     #   ",
        "# ##### ### # # ####### # ##### ### ### ",
        "#     # #   #   #     # #         #   # ",
        "##### # # ####### ### ##### ######### # ",
        "#   # # #   #   # # #     # #     #   # ",
        "# ### # ### # # # # ##### ### ### # ### ",
        "#       #     #   #           #     #   "
    ],
    "PositionStart": [ 9, 31 ],
    "PositionTarget": [ 27, 1 ]
}