{
    "Name": "The Easy Starter Level (With Yellow Track)",
    "MAP": [
        "########################################",
        "#           # #YYYYYYYYYYYYYYYYY#       ",
        "# ##### ### # #Y###############Y### # # ",
        "#   #   # #   #Y#  YYY#   #YYY#YYY# # # ",
        "##### ### ### #Y###Y#Y### #Y#Y###Y### ##",
        "#   # #   #   #Y#YYY#YYYYY#Y#YYY#YYY#   ",
        "# # # ### # ###Y#Y#######Y#Y###Y###Y# # ",
        "# #   #   #   #YYY#     #Y#YYY#YYY#Y# # ",
        "# ##### ##### ##### ### #Y###Y###Y#Y### ",
        "# #   #       #     #   #Y  #Y#S#YYY#   ",
        "# # # # ####### # #######Y###Y#Y##### # ",
        "# # #         # # #YYYYYYY#YYY#Y#     # ",
        "# # ######### # # #Y#######Y###Y##### ##",
        "# # #YYYYY#     # #Y#   #YYY#YYY#   #   ",
        "# ###Y###Y# #######Y# # #Y###Y### # ### ",
        "#YYYYY# #Y#   #YYYYY# # #YYYYY#   #     ",
        "#Y##### #Y#####Y##### # ####### ####### ",
        "#Y#YYY# #YYY#YYY#     # #       #   #   ",
        "#Y#Y#Y# ###Y#Y##### ### ### ##### # # ##",
        "#YYY#Y#   #Y#Y#     #       #     # # # ",
        "#####Y### #Y#Y# # ##### ########### # # ",
        "#YYY#YYY# #YYY# #     # #         # # # ",
        "#Y#Y###Y# ####### ### ### ####### # # # ",
        "#Y#YYYYY#       #   #     # #     #   # ",
        "#Y########### # ####### ### # ##### ### ",
        "#YYYYY#       #       #     # #   #     ",
        "#####Y# ############# ### ### # # ##### ",
        "#TYYYY#   #   #   #     # #   # #   #   ",
        "# ####### # # # # ##### ### ### ### # ##",
        "# #   #   # #   #     #     # #   # # # ",
        "# # # # ### ######### ####### ### # # # ",
        "#   # #           # # #   # #     #   # ",
        "##### ########### # # # # # # ####### # ",
        "#     #     # #     #   # #   #     #   ",
        "# ##### ### # # ####### # ##### ### ### ",
        "#     # #   #   #     # #         #   # ",
        "##### # # ####### ### ##### ######### # ",
        "#   # # #   #   # # #     # #     #   # ",
        "# ### # ### # # # # ##### ### ### # ### ",
        "#       #     #   #           #     #   "
    ],
    "PositionStart": [ 9, 31 ],
    "PositionTarget": [ 27, 1 ]
}