{
    "Name": "A ultimative (half) difficuilt maze.",
    "MAP":[
        "########################################",
        "#                   # #  S#             ",
        "# ####### ### ##### # # ### ########### ",
        "#   #   #   # #   #   # # #       #   # ",
        "##### # ### # # ### ### # # ##### # ### ",
        "#     # #   # #     #   #     #   # #   ",
        "# ##### ##### # ##### ######### ### # ##",
        "# #       #   #     #   #       #     # ",
        "# ####### # ####### ### # ####### ##### ",
        "#     #     #     #   #   #     # #     ",
        "# ### ##### # ### ######### ##### ### # ",
        "# # #     # #   #           #   #     # ",
        "# # ##### # ### ######### ### # ####### ",
        "#     #   # # # #     # #     #   #   # ",
        "##### # ### # # # # # # ######### # # # ",
        "#     # # # # # # # #       #   #   # # ",
        "# ##### # # # # ### ####### ### ##### # ",
        "# #     # #   #     #     #     #  T#   ",
        "# # ##### ### ####### ### ##### ### ####",
        "# # #     #   #       # #       #       ",
        "# # # # # # ### ####### ######### ##### ",
        "# # # # # #   # #   #     #       #     ",
        "### # # ##### # # # # # ### ### ### ####",
        "#   # #       #   # # #     # # # #     ",
        "# ### ############# # ####### # # ##### ",
        "# # # # #     #   # #     #   # #     # ",
        "# # # # # ### # # # ##### ### # ### ### ",
        "# # #   # # # # #   #   #   # #   #     ",
        "# # ### # # # # ####### ### # ### ######",
        "# #   # #   # #   #       # #   #       ",
        "# # ### ### # ### # ####### # # ####### ",
        "# #   #   # #   # # #         #   #   # ",
        "# ### ### # # ### # # ############# # # ",
        "#   #   # # # #   #   #     #     # # # ",
        "### # ### # # # ### ####### # ### # # # ",
        "#   #     # #   #           # #     #   ",
        "# ######### ############### # ######### ",
        "#   #       #       #   #   #   #   #   ",
        "# # # ########### # # # ####### # # # ##",
        "# #               #   #         # #     "
    ],
    "PositionStart": [ 1, 25 ],
    "PositionTarget": [ 17, 35 ],
    "Flags": {
        "RemoveTiles": false
    }
}