{
    "Name": "A difficuilt maze!",
    "MAP":[
        "########################################",
        "#           #       #   #               ",
        "# ##### ### ##### # # # # # ########### ",
        "# #     # #     # # # #   #   #         ",
        "# # ##### ##### # ### ####### # ########",
        "# # #       #   # #         # #   #   # ",
        "# # # ####### ### # ####### # ### # # # ",
        "# # #             #   #  S# # #     #   ",
        "### # ############### # ##### ##########",
        "#   # #               #     #           ",
        "# ##### ################### # ######### ",
        "# #     #         #       # # # #       ",
        "# # ######### ### ### ### # # # # ##### ",
        "# #   #     #   #     #   # #   #   #   ",
        "# ### # ### # # ##### ##### # ##### ####",
        "#   # # #   # # #T  # #     # #   #     ",
        "### # # # ##### # # # # ####### # ##### ",
        "#   # # #       # #   # #       #     # ",
        "# # # # ######### ##### ### ######### # ",
        "# # #   #     # #   # #   #       #   # ",
        "# # ##### # # # ### # ### ### ### # ### ",
        "# #   #   # #     # #   #   # #   # #   ",
        "# ##### ### ####### ### ### ### ### # # ",
        "#       # # #   #         #   # # #   # ",
        "# ####### # # # # ####### ### # # ##### ",
        "# #       #   #   #     # #   # #       ",
        "# ####### ######### ### ### ### # ######",
        "# #       #       # # #     #   # #     ",
        "# # ##### # ### ### # ######### # # ### ",
        "# # #   # # #   #   #   #     # #   #   ",
        "# # ### # ### ### ### # # ### # ##### ##",
        "# # #   #   #   # #   # #   # # # #   # ",
        "# # # ##### ### # ### # # # # # # # ### ",
        "# # #     # #   #   # # # # #   # # #   ",
        "# # # # ### # # ### # # # # ##### # # ##",
        "#   # #   #   #   #   # # # #     # #   ",
        "##### ### ####### ##### # # # ##### ### ",
        "# #   # # #     # #   # # # #     #     ",
        "# # ### # # ### # # # # ### # ### ##### ",
        "#       #     #     # #     #   #       "
    ],
    "PositionStart": [ 7, 25 ],
    "PositionTarget": [ 15, 17 ],
    "Flags": {
        "RemoveTiles": true
    }
}
